11111111111111111111111111111111
1P00011100011IC1000111000110C001
110100010001000100011100011IC001
1E00010000000001000111000110C001
1C00110011100C01000111000110C001
10001001C00I0001000111000110C001
1C00I00I10011111000111000110C001
1000000010000000000000000000I001
10000000111100000C00000000000001
10001100000000000I00011111011111
10001100000000000000010000000001
110000000I0000000C00010000I00001
1I10000000000000000001000CCC0I01
11111111111111111111111111111111
