1111111111111111111
1000000000000000I01
100000I001110000101
1E000000000P00001C1
1110000110000000001
1000011000010110001
1C0EI00001000000IC1
1111111111111111111
