1111111111111
1000000000001
100000000E111
10000000PC0I1
10000P0000111
1000000P0C001
1111111111111
