1111111111111111111111
1000000001110000000001
1000000001I10000000001
1000011111E11111000001
1000100000P00000100001
1000011111011111000001
1000000001010000000001
1EC0000001110000000001
1111111111111111111111
