111111111111111111111
100000000000000000001
100000000000000000001
100111110000001111001
100100010111001001001
1001I0I10EI1001I01001
100111110C11001111001
100000000PCE000000001
111000000000000000111
1I10000000000000001I1
111111111111111111111
