11111111111
10000000001
1P00C00E001
10000000001
11111111111
