1111111111111111111
1I1C0P00000000001I1
10100000011100001I1
11000000C00P0011111
1IECC0011000001I001
1100011000010110001
110E0000010000100I1
1111111111111111111
