1111111111111111111111
1000000001110000000001
1000000001I10000000I01
1000011111011111000001
1000100000P00000100001
1000011111011111000001
1000010001I10000000I01
1EC0000001110000000001
1111111111111111111111
