111111111111111111
10000000P0000000I1
1C10000110000000E1
1000C00000011001C1
1I01000E000C000101
100100000110000001
10C001110000I00011
101100000000000001
10C0010010010100I1
10I000000C00000001
111111111111111111
