111111111111
1110S1111111
111CP111E111
111111111111
