11111111111111111111
10000000010000000011
1000CE00101000000001
10011111101111100001
1010001001P000010001
100111111I1111100001
100000001I1000000001
10000000101000000001
11111111111111111111
